############
#          #
#       ####
#          #
##         #
#        ###
#        ###############
#                     O#
#       X              #
# #  P                 #
########################