     #######
######     #
#P O   #X  #
#####      #
    ########